-,-,-,-,-,-,-,b,b,b,b,b
-,-,-,-,-,-,-,-,-,b,b,b
-,-,-,-,-,-,-,-,-,-,b,b
-,-,-,-,-,-,-,-,-,-,-,-
-,-,-,-,-,-,-,-,-,-,b,b
cl,-,-,-,-,-,-,-,-,b,b,b
-,-,-,-,-,-,-,b,b,b,b,b
door,down,right,,,,,,,,,
enemy,Aquamentus,,,,,,,,,,