w,w,w,w,w,-,-,w,w,w,w,w
w,-,-,-,w,-,-,k,-,w,-,w
w,-,w,-,w,-,w,w,-,w,-,w
-,-,w,-,w,-,-,w,-,w,-,-
w,-,w,-,w,w,-,w,-,w,-,w
w,-,w,-,-,-,-,w,-,-,-,w
w,w,w,w,w,-,-,w,w,w,w,w
door,down,,,,,,,,,,
enemy,Stalfos,Stalfos,Stalfos,,,,,,,,
keyedDoor,up,,,,,,,,,,