-,-,-,-,-,-,-,-,-,-,-,-
-,b,b,b,b,b,b,b,b,b,b,-
-,b,-,-,p,-,-,p,-,-,b,-
-,b,-,p,-,-,-,-,p,-,b,-
-,b,-,-,-,-,-,-,-,-,b,-
-,b,b,b,b,-,-,b,b,b,b,-
-,-,-,-,-,-,-,-,-,-,-,-