-,-,-,-,-,-,-,-,-,-,-,-
-,b,b,-,-,-,-,-,-,b,b,-
-,-,-,-,-,-,-,-,-,-,-,-
-,-,-,-,-,b,b,-,-,-,m,-
-,-,-,-,-,-,-,-,-,-,-,-
-,b,b,-,-,-,-,-,-,b,b,-
-,-,-,-,-,-,-,-,-,-,-,-
door,up,left,right,,,,,,,,
breakable,down,,,,,,,,,,
enemy,Goriya,Goriya,Goriya,Goriya,Goriya,,,,,,