-,-,-,-,-,-,-,-
-,-,-,-,-,-,-,-
-,-,0,5,-,-,-,-
-,-,-,b,-,3,1,-
-,0,4,a,2,9,-,-
-,-,7,6,1,-,-,-
-,-,-,b,-,-,-,-
-,-,0,e,1,-,-,-