w,w,w,w,w,-,-,w,w,w,w,w
w,-,-,-,w,-,-,-,-,w,-,w
w,-,w,-,w,-,w,w,-,w,-,w
-,-,w,-,w,-,-,w,-,w,-,-
w,-,w,-,w,w,-,w,-,w,-,w
w,-,w,-,-,-,-,w,-,-,-,w
w,w,w,w,w,-,-,w,w,w,w,w
door,down,,,,,,,,,,
enemy,Stalfos,Stalfos,Stalfos,,,,,,,,
keyedDoor,up,,,,,,,,,,