-,-,-,-,-,-,-,-,-,-,-,-
-,-,-,-,-,-,b,-,-,-,-,-
-,-,-,-,-,b,-,b,-,-,-,-
-,-,-,-,b,-,st,-,b,-,-,-
-,-,-,-,-,b,-,b,-,-,-,-
-,-,-,-,-,-,b,-,-,-,-,-
-,-,-,-,-,-,-,-,-,-,-,-
door,right,,,,,,,,,,