-,-,-,-,-,-,-,b,b,b,b,b
-,-,-,-,-,-,-,-,-,b,b,b
-,-,-,-,-,-,-,-,-,-,b,b
-,-,-,-,-,-,-,-,-,-,-,-
-,-,-,-,-,-,-,-,-,-,b,b
-,-,-,-,-,-,-,-,-,b,b,b
-,-,-,-,-,-,-,b,b,b,b,b
door,down,right,,,,,,,,,