-,-,-,-,-,-,-,-,-,-,-,-
-,w,w,w,-,-,-,-,w,w,w,-
-,w,-,-,-,-,-,-,-,-,w,-
-,w,-,w,w,w,w,w,w,-,w,-
-,w,-,-,-,-,-,-,-,-,w,-
-,w,w,w,-,-,-,-,w,w,w,-
-,-,-,-,-,-,-,-,-,-,-,-
door,left,down,,,,,,,,,
enemy,Goriya,Goriya,Goriya,,,,,,,,