-,-,-,-,-,-,-,-,-,-,-,-
-,b,b,b,b,b,b,b,b,b,b,-
-,b,-,-,f1,-,-,d1,-,-,b,-
-,b,-,f1,-,-,-,-,d1,-,b,-
-,b,-,-,-,-,-,-,-,-,b,-
-,b,b,b,b,-,-,b,b,b,b,-
-,-,-,-,-,-,-,-,-,-,-,-