-,-,-,-,-,-,-,-,-,-,-,-
-,b,-,b,-,b,b,-,b,-,b,-
-,-,-,-,-,-,-,-,-,-,-,-
-,b,-,b,-,b,b,-,b,-,b,-
-,-,-,-,-,-,-,-,-,-,-,-
-,b,-,b,-,b,b,-,b,-,b,-
-,-,-,-,-,-,-,-,k,-,-,-
door,left,,,,,,,,,,
enemy,DarkNut,DarkNut,DarkNut,DarkNut,DarkNut,,,,,,
keyedDoor,up,,,,,,,,,,