-,-,-,-,-,-,-,-,-,-,-,-
-,-,-,-,-,k,-,-,-,-,-,-
-,-,b,-,-,-,-,-,-,b,-,-
-,-,-,-,-,-,-,-,-,-,-,-
-,-,b,-,-,-,-,-,-,b,-,-
-,-,-,-,-,-,-,-,-,-,-,-
-,-,-,-,-,-,-,-,-,-,-,-
door,left,right,down,,,,,,,,
breakable,up,,,,,,,,,,
enemy,Stalfos,Stalfos,Stalfos,Gibdo,Gibdo,,,,,,