-,-,-,-,-,-,-,-,-,-,-,-
-,b,b,-,-,-,-,-,-,b,b,-
-,-,-,-,-,-,-,-,-,-,-,-
-,-,-,-,-,b,b,-,-,-,-,-
-,-,-,-,-,-,-,-,-,-,-,-
-,b,b,-,-,-,-,-,-,b,b,-
-,-,-,-,-,-,-,-,-,-,-,-
door,up,left,right,,,,,,,,
breakable,down,,,,,,,,,,